PWPEEPMPPME
EMEPWMEPMPE
EEMEPEEMPME
EEEMEPPMEPM
EWWWMEMWWME
WEWEPPMEPEE
EMEPWMEPWWW
EEMEPEEMPME
EEEMEPPMEPM
EEEMEPPWWPM
EWWWMEMEPWW